###.....###
..##.#.####
.##..###..#
##........#
#......#..#
.##..@##...
..#..#.....
.##.##.#.##
.#.......##
.#.......##
###.....###